NO nord
SO sud
WE ovest
EA est

C 
F

 111111
10000001
1000N001
10000001
 111111