NO ./textures/NO_WALL.xpm
SO ./textures/SO_wall.xpm
WE ./textures/WE_WALL.xpm
EA ./textures/EA_WALL.xpm

C 0, 255, 0
F 0,0,0

111111111111111
1000000000000001
1000000000000001  11111
10000000000000001100001
1110N000000000000000001
110000000000000000000001
11000000000000000000001  
1000000000000000000011   
1111111111111111111111   