NO nord
SO sud
WE ovest
EA est

C 
F 

111111111111111
1000000000000001
1000000000000001  11111
10000000000000001100001
11100W00000000000000001
110000000000000000000001 111
11000000000000000000001  101
1000000000000000000011   11
1111111111111111111111   11