NO nord
SO sud
WE ovest
EA est

F floor
C ceiling

111111111111111
1000000000000001
1000000000000001  11111
10000000000000011100001
11100000000000000000001
11000000000000000000001
11000000000000000000001
1000000000000000000001
1111111111111111111111