NO nord
SO sud
WE ovest
EA est

C 
F 

111111111111111
1000000000000001
1000000000000001  11111
10000000000000001100001
11100N00000000000000001
110000000000000000000001
11000000000000000000001  
1000000000000000000011   
1111111111111111111111   