NO ./textures/NO_wall.xpm
SO ./textures/SO_wall.xpm
WE ./textures/WE_wall.xpm
EA ./textures/EA_wall.xpm

C 255, 255, 255
F 0, 0, 0

111111111111111
1000000000000001
1000000000000001  11111
10000000000000001100001
11100N00000000000000001
110000000000000000000001
11000000000000000000001  
1000000000000000000011   
1111111111111111111111   