NO ./src/textures/xpms/N_wall.xpm
SO ./src/textures/xpms/S_wall.xpm
WE ./src/textures/xpms/W_wall.xpm
EA ./src/textures/xpms/E_wall.xpm

C 123,23,46
F 2,3,4

111111111111111111111111
100000000000000000000001
100100010001000100010001
100000000000000000000001
10010001000N000100010001
100000000000000000000001
100100010001000100010001
100000000000000000000001
111111111111111111111111