NO ./src/textures/xpms/N_wall.xpm
SO ./src/textures/xpms/S_wall.xpm
WE ./src/textures/xpms/W_wall.xpm
EA ./src/textures/xpms/E_wall.xpm

C 123, 23,46
F 2,3,4

        111111111111111111111
        100000000000000000001
        100010001000010001001
        100000000000000000001
1111111100010001000100010001111111111
1000010001000000000000000000000010001
10001001000010001000N0001000100000001
1000000000000000000000000000000000001
1000100100001000100010001000100000001
1000000001000000000000010000000010001
1111111110000010000100000011111111111
        10001000010000100001
        10000000000000000001
        10001000010000100001
        11111111111111111111