NO ./src/textures/xpms/N_wall.xpm
SO ./src/textures/xpms/S_wall.xpm
WE ./src/textures/xpms/W_wall.xpm
EA ./src/textures/xpms/E_wall.xpm


C 123, 23, 46
F 2,3,4
        111111111111111111111
        100000000000000000001
        100010001000010001111
        1000000000000000N01             
1111111100010001000100010001111111111
1000010001000011111111111100000001000111111111
100010010000101   11111   1100000010001000000011   
100000000000001   11001   110000000000000000001
100010010000101   11111   101000100010000000111
10000000010000111111111111100000000100011111
11111111100000100001000000111111111111111
        10001000010000100001
        10000000000000000001
        10001000010000100011
        11111111111111111111


